## #             #          #         ###      #              ##        ####  ##            #       
#      #              #        #      ###                          #                            #   
  !   ###   #       # #                 #          #   #        #  ####  #          #  #    ##      
     ###          #                   # #    #                           # #        #     ###    #  
#                 #             ##               #                      ##                       ## 
#  #             ##  #      #             #          #            ##         # ###               ## 
#  #          #  ##                  #               #            #                            #####
#    ##           #       #     #             #         ###       #   #                  !     #####
#                         #            # #      ##            #                                #####
         #    #               #          #    #                              #    # #             ##
                           #                                  #       ###    #      #             ##
                  #        #        #                !                       #             #      ##
   #     ###           #      #     #                                     #  #             #       #
                   #       #        #  #                    ##                              ##      
  ##  #     #             ##   #      ##                    ##                                    ##
            #                  #####      ###  ###  # ##            ###          ###  #    #      ##
   #       #                ##             #   ###  #  #  #         ###  ##      ###              ##
#              #             ##                 #                                 ##        #     ##
                     #       #   #                    #                    #      ##              # 
        #                    #   #                         ###      #      #      #       #       # 
                                       #       #           ### #                      #   #         
###                ##                                       ##                                      
#####    #                               #         ###                 ##       ##                # 
####                                         #     #### ##     ##  ##  ##     ####              # ##
####                         !                     ####                     #  #     #            ##
####                                  #           #####       #             #     ####     !      ##
####              #                   #      #       #       ####   ###            ####             
#####             #  ##               #  #   #  #    #       #####  ###             ###             
###           #      ##   #  #    #                          #           #                #         
###      #  #                                                            ####      ##               
###              #                          #  ##           #      #      ##       #         ### ###
##           #  #         #           #    #               #                                 ### ###
#                             #       #  ###          #                             ###      ##   ##
      #                                                 #     !                       #   ##      ##
                                #                  #    #            # #              #         ####
               !                                                                 #                ##
   #                  #      #                     ##              #   #   #        #        #    ##
       #  #          ## #      ##  #     #  ##          #######       ##       #   ##               
## #  ##     #               # ##          ###           ######  #               #    #             
##                           #    ## ##    #             ######        ##                   !    ###
##               #                              #                      ###              #       ####
##               #            #      #         ###              #                 #     ##      ####
##              ##                   ##  ## ####         #      #                       ## #    ####
##              ##           #       ##  #                      #    ##  #####     #           ###  
##              ####              #                #            ##        #####               ##    
#       # # #                  #  #   #                       # #           ###      #              
   #                          #       #      #    #    #                                      #     
   #     #            # #     #       #           #                                   #            #
#   #    #                            #     #  #      #  ##              # #                       #
    ##         ##               #              #      #                                       #   ##
   ###     #   ##                                                                                  #
   ###     #   #  #                             #             #                                     
     #            ##     #     #        ##            ##      #                      #           #  
           # #    #                 # ###       #         #      #           ###                    
                      #     #   #               #         #    #             ###           #       #
#      ##                                    # ##         #    ###            ###   ##        #### #
   ##   #                          ##        #    #       #           ##       ###  ####   #       #
        #               #     #       ##                           #   ## #     ##  ####        ####
         #      #        #            ###  ##                  #                 # #   #          ##
     #   #            #                 #  #                   #        #        #   #   ##        #
                   ##  #           ###  #            ### #            #              #   ##        #
##          # #          ##  ##    ####                              ##  #         # #   ##        #
#                                   ###                                                            #
                                ### #                                          #  #                #
#   #    ##     ##    ##         #       #    #       #  ###      #    ##  #    #                 ##
##  ##          ##                     #    # # #                 # #  ## #             #          #
                 #             #       #            #                                #  # #         
     #                 #          #                 ##      ##      #  #                            
   #    #      #                   #                             # ##                               
        #              #                  ##              #   #      #      #            #        ##
  #       #        #                      ##            #                  ##         #    ###      
##                               ##      #####          #            ###   ##              ##       
#                   #                                                       #         #  ##         
                         #     #      #             #   #         ##               #             ###
                                      ##        #   ###     #           ##       #               #  
   ##                                  #            ####                 #                 # #      
    #                                       ##   #  ###            #         #                      
#        #     # #                          #       ###        #      #      #  #     #             
#      #                 #    #         #   #                      #                 #   #         #
#      #          #                                                                              ###
#                                            #  ##   #   ##       #      ##        #              ##
#                                  ###               #   ##     # #   #  ##             #         ##
          ##  #     #          #######            #               #   ## ## #         ###     #  ###
       #  ##  #                #######                                ##            #####         ##
#        ##       ##              #                            ##              ##     ###           
#    #   ##   ##            ##    #                           ###  #          #       ###           
         #                    #   #           #####        #   ##      #               ####         
 ##             # #                           ##  #        #                 #         ###          
##                              ##     # #     #              #          #  ##  ##      ##          
##           #                           #                               #                          
#       ##   #                               #          #                               #          #
#       #        #               #         # #     #            #                       #           
                ##               #   ####         ##                      #   ##      #         #   
#               ##  ##  ## #  #      ####               ##             #      ##     ##             
#                    #                        #        #####       #   ##    ####           #       
          #                     ##      #          #   ##              #   #  ####      #   #    #  
   #           ##    ###  #           #                                    #  ######                
     #         ###    ##     #                   #                         #########                
#             ###            #   ###                    #   #         #    #########      #####    #
##     ##     ###       ### #######        # ######   #              ##  ########### # #  ####      
